U U U U U U U U U U U U U U U
U M E E B E B B E E B B E E U
U E U E U E U E U E U B U E U
U B B E E B E E E E B E E E U
U E U E U B U E U E U E U E U
U B E B B E E G E P E B E B U
U E U E U E U E U E U E U E U
U E E E E B E B B E E E E B U
U B U S U E U E U E U L U B U
U E B E E B E E B B E E B E U
U B U E U E U P U E U E U E U
U E B B E E E B E B E E P E U
U E U E U E U E U E U B U E U
U P E B E E E E E B B G E E U
U U U U U U U U U U U U U U U