U U U U U U U U U U U U U U U
U M E E E B E B E E E P B E U
U B U E U E U E U B U B U B U
U B E E B E E S E E E E B E U
U E U E U E U E U E U E U B U
U E E B E P B E E E E B E E U
U E U E U E U E U B U E U B U
U E E E B E E B P E E E B E U
U G U E U E U E U E U B U E U
U B B B E E E E E B E E B E U
U E U E U E U E U E U E U B U
U B E B E B E G B B L E E B U
U E U E U B U E U P U B U E U
U E E E B E E E E B E E A B U
U U U U U U U U U U U U U U U