U U U U U U U U U U U U U U U
U M E E E E E E B B E E E G U
U E U B U E U B U B U E U E U
U B E B E B B E E E B E B E U
U E U E U E U E U P U B U B U 
U B E E B E B S E B E E E E U
U E U E U B U E U E U E U E U
U B E E E B E E E B E E E P U
U E U E U E U E U E U E U E U
U L P E E B E E B E B B E E U
U B U E U E U B U B U E U B U
U E B B S E E E E E B E E B U
U E U E U E U B U E U E U E U
U B E E E B E B B E E B B E U
U U U U U U U U U U U U U U U