U U U U U U U U U U U U U U U
U M E E E E B B E E E E A B U
U E U E U E U E U B U B U E U
U B E P B B E S E B B B E B U
U B U E U E U E U E U E U B U
U E E B E E E B E E B P E E U
U E U E U E U E U E U E U E U
U B E S E B E L E B E G E B U
U E U E U E U E U E U E U E U
U E E B E E E B E E E B E E U
U P U E U E U E U E U E U B U
U B E B B B E G E B B B E B U
U E U E U E U E U E U E U E U
U B B E E E E B E E E E E B U
U U U U U U U U U U U U U U U